pos.x=10
pos.y=10
mov.x=1
mov.y=0
cnt.x=40
cnt.y=40
dlugosc=15
zbierek=10
bonusow=2
clockow=1
reftime=120
ref_mul=0.0005
igntime=120
ign_mul=0.0002
end!
11111111111111110000001111000000111111111111
10000000000000000000000000000000000000000001
10000000000000000000000000000000000000000001
10000000000000000000000000000000000000000001
10000000000000000000000000000000000000000001
10000000000000000000000000000000000000000001
10000000000111111111111111000000000000000001
10000000000111111111111111000000000000000001
00000000000000000000000000000000000000000000
00000000000000000000000000000000000000000000
00000000000000000000000000000000000000000000
10000000000000000000000000000000000000000001
10000000000000000000000000000000000000000001
10000000000000000000000000000000000000000001
10000000000000000000000000111111110000000001
10000000000000000000000000111111110000000001
10000000000000000000000000000000110000000001
10000000000000000000000000000000110000000001
10000000000000000000000000000000110000000001
10000000000000000000000000000000110000000001
10000000000000000000000000000000110000000001
10000000000000000000000000000000110000000001
00000000000000000000000000000000110000000000
00000000000000000000000000000000110000000000
00000000000000000000000000000000110000000000
00000000000000000000000000000000110000000000
00000000000000000000000000000000110000000000
00000000000000000000000000000000110000000000
00000000000000000000000000000000110000000000
00000000000000000000000000000000110000000000
11111111111111110000001111000000111111111111
